3 13 31
###############################
#p * *2       *   * * *      *#
# # # # #*# # #*# # # # # #*# #
#    * * * * **      *    **  #
# #*# # # # #1# #b#1# # # # #*#
#          *     **      *  **#
# # #*# # # # # #*#*#*#*# # # #
#   *    f   *   * *x* *      #
# # # # #*# # # # # # #*# #*# #
#      *   1  s  *1           #
# # # # # # # # # #*# # # # #*#
#   *     *    2              #
###############################